"filename", "language", "Python", "JSON", "XML", "Shell Script", "Batch", "comment", "blank", "total"
"c:\Repository\pcscf_service_tool\bin\pcscf-service-tool.bat", "Batch", 0, 0, 0, 0, 2, 0, 2, 4
"c:\Repository\pcscf_service_tool\bin\pcscf-service-tool.sh", "Shell Script", 0, 0, 0, 16, 0, 14, 7, 37
"c:\Repository\pcscf_service_tool\coverage.xml", "XML", 0, 0, 638, 0, 0, 2, 1, 641
"c:\Repository\pcscf_service_tool\etc\connections.json", "JSON", 0, 124, 0, 0, 0, 0, 1, 125
"c:\Repository\pcscf_service_tool\etc\connections.test.json", "JSON", 0, 58, 0, 0, 0, 0, 1, 59
"c:\Repository\pcscf_service_tool\etc\pcscf-service-tool\pcscf-messages.json", "JSON", 0, 25, 0, 0, 0, 0, 1, 26
"c:\Repository\pcscf_service_tool\etc\pcscf-service-tool\pcscf-node.json", "JSON", 0, 77, 0, 0, 0, 0, 1, 78
"c:\Repository\pcscf_service_tool\etc\pcscf-service-tool\pcscf-node.ref.json", "JSON", 0, 12, 0, 0, 0, 0, 1, 13
"c:\Repository\pcscf_service_tool\etc\pcscf-service-tool\pcscf-service-tool.json", "JSON", 0, 4, 0, 0, 0, 0, 1, 5
"c:\Repository\pcscf_service_tool\etc\pcscf-service-tool\pcscf-smfvoice.json", "JSON", 0, 338, 0, 0, 0, 0, 1, 339
"c:\Repository\pcscf_service_tool\etc\pcscf-service-tool\pcscf-smfvoice.ref.json", "JSON", 0, 66, 0, 0, 0, 0, 1, 67
"c:\Repository\pcscf_service_tool\lib\__init__.py", "Python", 0, 0, 0, 0, 0, 0, 1, 1
"c:\Repository\pcscf_service_tool\lib\common.py", "Python", 4, 0, 0, 0, 0, 4, 3, 11
"c:\Repository\pcscf_service_tool\lib\eri_connection.py", "Python", 114, 0, 0, 0, 0, 91, 36, 241
"c:\Repository\pcscf_service_tool\lib\eri_connection_stub.py", "Python", 91, 0, 0, 0, 0, 16, 17, 124
"c:\Repository\pcscf_service_tool\lib\pcscf_service_common.py", "Python", 33, 0, 0, 0, 0, 42, 13, 88
"c:\Repository\pcscf_service_tool\lib\pcscf_service_tool.py", "Python", 469, 0, 0, 0, 0, 214, 104, 787
"c:\Repository\pcscf_service_tool\tests\__init__.py", "Python", 0, 0, 0, 0, 0, 0, 1, 1
"c:\Repository\pcscf_service_tool\tests\etc\pcscf-service-tool.json", "JSON", 0, 4, 0, 0, 0, 0, 1, 5
"c:\Repository\pcscf_service_tool\tests\etc\required_key_less.json", "JSON", 0, 108, 0, 0, 0, 0, 1, 109
"c:\Repository\pcscf_service_tool\tests\test_common.py", "Python", 214, 0, 0, 0, 0, 102, 75, 391
"c:\Repository\pcscf_service_tool\tests\test_eri_connection.py", "Python", 809, 0, 0, 0, 0, 339, 260, 1408
"c:\Repository\pcscf_service_tool\tests\test_tool_01_check_args.py", "Python", 805, 0, 0, 0, 0, 302, 206, 1313
"c:\Repository\pcscf_service_tool\tests\test_tool_02_load_config.py", "Python", 227, 0, 0, 0, 0, 58, 69, 354
"c:\Repository\pcscf_service_tool\tests\test_tool_03_out_info.py", "Python", 134, 0, 0, 0, 0, 40, 38, 212
"c:\Repository\pcscf_service_tool\tests\test_tool_04_open_close_client.py", "Python", 371, 0, 0, 0, 0, 90, 92, 553
"c:\Repository\pcscf_service_tool\tests\test_tool_05_is_stop_ng.py", "Python", 456, 0, 0, 0, 0, 126, 110, 692
"c:\Repository\pcscf_service_tool\tests\test_tool_06_get_status.py", "Python", 576, 0, 0, 0, 0, 149, 156, 881
"c:\Repository\pcscf_service_tool\tests\test_tool_07_down_change_status.py", "Python", 746, 0, 0, 0, 0, 166, 172, 1084
"c:\Repository\pcscf_service_tool\tests\test_tool_08_up_change_status.py", "Python", 746, 0, 0, 0, 0, 166, 172, 1084
"c:\Repository\pcscf_service_tool\tests\test_tool_09_do_revert.py", "Python", 145, 0, 0, 0, 0, 28, 42, 215
"c:\Repository\pcscf_service_tool\tests\test_tool_10_status_check_before.py", "Python", 478, 0, 0, 0, 0, 135, 147, 760
"c:\Repository\pcscf_service_tool\tests\test_tool_11_status_check_after.py", "Python", 347, 0, 0, 0, 0, 90, 102, 539
"c:\Repository\pcscf_service_tool\tests\test_tool_12_main.py", "Python", 1837, 0, 0, 0, 0, 383, 336, 2556
"Total", "-", 8602, 816, 638, 16, 2, 2557, 2172, 14803